z.B.	zum beispiel
d.h.	dass hei√üt
Dr.	doktor
Mr.	mister
Mrs.	misses
Ms.	miss
Nr.	nummer
2D	zwei-D
2-D	zwei-D
3D	drei-D
3-D	drei-D
3-D-Mammogram	drei-D-Mammogram
3D-Mammogram	drei-D-Mammogram
2-D-Mammogram	zwei-D-Mammogram
2D-Mammogram	zwei-D-Mammogram
3-D-Mammographie	drei-D-Mammographie
3D-Mammographie	drei-D-Mammographie
2-D-Mammographie	zwei-D-Mammographie
2D-Mammographie	zwei-D-Mammographie
3-D-Drucker	drei-D-Drucker
3D-Drucker	drei-D-Drucker