vigesimoprimero	veintiuno
vigesimoprimera	veintiuno
vigesimoprimer	veintiuno
vigésimo primero	veintiuno
vigésimo primera	veintiuno
vigésima primera	veintiuno
vigésimo primer	veintiuno
vigesimosegundo	veintidós
vigesimosegunda	veintidós
vigésimo segundo	veintidós
vigésimo segunda	veintidós
vigésima segunda	veintidós
vigesimotercero	veintitrés
vigesimotercera	veintitrés
vigesimotercer	veintitrés
vigésimo tercero	veintitrés
vigésimo tercera	veintitrés
vigésima tercera	veintitrés
vigésimo tercer	veintitrés
vigesimocuarto	veinticuatro
vigesimocuarta	veinticuatro
vigésimo cuarto	veinticuatro
vigésimo cuarta	veinticuatro
vigésima cuarta	veinticuatro
vigesimoquinto	veinticinco
vigesimoquinta	veinticinco
vigésimo quinto	veinticinco
vigésimo quinta	veinticinco
vigésima quinta	veinticinco
vigesimosexto	veintiséis
vigesimosexta	veintiséis
vigésimo sexto	veintiséis
vigésimo sexta	veintiséis
vigésima sexta	veintiséis
vigesimoséptimo	veintisiete
vigesimoséptima	veintisiete
vigésimo séptimo	veintisiete
vigésimo séptima	veintisiete
vigésima séptima	veintisiete
vigesimoctavo	veintiocho
vigesimoctava	veintiocho
vigesimooctavo	veintiocho
vigesimooctava	veintiocho
vigésimo octavo	veintiocho
vigésimo octava	veintiocho
vigésima octava	veintiocho
vigesimonoveno	veintinueve
vigesimonovena	veintinueve
vigésimo noveno	veintinueve
vigésimo novena	veintinueve
