januar	jan.
Januar	Jan.
jänner	jan.
Jänner	Jan.
februar	feb.
Februar	Feb.
märz	mär.
März	Mär.
april	apr.
April	Apr.
mai	mai
Mai	Mai
juni	jun.
Juni	Jun.
juno	jun.
Juno	Jun.
juli	jul.
Juli	Jul.
julei	jul.
Julei	Jul.
august	aug.
August	Aug.
september	sep.
September	Sep.
oktober	okt.
Oktober	Okt.
november	nov.
November	Nov.
dezember	dez.
Dezember	Dez.
