.com	punkt com
.net	punkt net
.org	punkt org
.jp	punkt jp
.de	punkt de
.uk	punkt uk
.fr	punkt fr
.br	punkt br
.it	punkt it
.ru	punkt ru
.es	punkt es
.me	punkt me
.gov	punkt gov
.pl	punkt pl
.ca	punkt ca
.au	punkt au
.cn	punkt cn
.co	punkt co
.in	punkt in
.nl	punkt nl
.edu	punkt edu
.info	punkt info
.eu	punkt eu
.ch	punkt ch
.id	punkt id
.at	punkt at
.kr	punkt kr
.cz	punkt cz
.mx	punkt mx
.be	punkt be
.tv	punkt tv
.se	punkt se
.tr	punkt tr
.tw	punkt tw
.al	punkt al
.ua	punkt ua
.ir	punkt ir
.vn	punkt vn
.cl	punkt cl
.sk	punkt sk
.ly	punkt ly
.cc	punkt cc
.to	punkt to
.no	punkt no
.fi	punkt fi
.us	punkt us
.pt	punkt pt
.dk	punkt dk
.ar	punkt ar
.hu	punkt hu
.tk	punkt tk
.gr	punkt gr
.il	punkt il
.news	punkt news
.ro	punkt ro
.my	punkt my
.biz	punkt biz
.ie	punkt ie
.za	punkt za
.nz	punkt nz
.sg	punkt sg
.ee	punkt ee
.th	punkt th
.io	punkt io
.xyz	punkt xyz
.pe	punkt pe
.bg	punkt bg
.hk	punkt hk
.rs	punkt rs
.lt	punkt lt
.link	punkt link
.ph	punkt ph
.club	punkt club
.si	punkt si
.site	punkt site
.mobi	punkt mobi
.by	punkt by
.cat	punkt cat
.wiki	punkt wiki
.la	punkt la
.ga	punkt ga
.xxx	punkt xxx
.cf	punkt cf
.hr	punkt hr
.ng	punkt ng
.jobs	punkt jobs
.online	punkt online
.kz	punkt kz
.ug	punkt ug
.gq	punkt gq
.ae	punkt ae
.is	punkt is
.lv	punkt lv
.pro	punkt pro
.fm	punkt fm
.tips	punkt tips
.ms	punkt ms
.sa	punkt sa
.app	punkt app
.lat	punkt lat
.pk	punkt pk
.ws	punkt ws
.top	punkt top
.xn--p1ai	punkt xn--p1ai
.pw	punkt pw
.ai	punkt ai
.kw	punkt kw
.ml	punkt ml
.su	punkt su
.lu	punkt lu
.nu	punkt nu
.ec	punkt ec
.uy	punkt uy
.az	punkt az
.ma	punkt ma
.st	punkt st
.asia	punkt asia
.im	punkt im
.am	punkt am
.email	punkt email
.ke	punkt ke
.eg	punkt eg
.live	punkt live
.md	punkt md
.uz	punkt uz
.today	punkt today
.ge	punkt ge
.ba	punkt ba
.bo	punkt bo
.blog	punkt blog
.lk	punkt lk
.do	punkt do
.one	punkt one
.ve	punkt ve
.media	punkt media
.sh	punkt sh
.vip	punkt vip
.life	punkt life
.guru	punkt guru
.mp	punkt mp
.int	punkt int
.tz	punkt tz
.desi	punkt desi
.jo	punkt jo
.mk	punkt mk
.np	punkt np
.py	punkt py
.mu	punkt mu
.mn	punkt mn
.re	punkt re
.travel	punkt travel
.tn	punkt tn
.gd	punkt gd
.sn	punkt sn
.cam	punkt cam
.shop	punkt shop
.mil	punkt mil
.tokyo	punkt tokyo
.gg	punkt gg
.kg	punkt kg
.cr	punkt cr
.li	punkt li
.cu	punkt cu
.hn	punkt hn
.eus	punkt eus
.rocks	punkt rocks
.bd	punkt bd
.dev	punkt dev
.fun	punkt fun
.video	punkt video
.gt	punkt gt
.bz	punkt bz
.space	punkt space
.store	punkt store
.mt	punkt mt
.name	punkt name
.work	punkt work
.porn	punkt porn
.pub	punkt pub
.kh	punkt kh
.icu	punkt icu
.as	punkt as
.cy	punkt cy
.pr	punkt pr
.careers	punkt careers
.ps	punkt ps
.dz	punkt dz
.iq	punkt iq
.ltd	punkt ltd
.pa	punkt pa
.sv	punkt sv
.qa	punkt qa
.design	punkt design
.sc	punkt sc
.sy	punkt sy
.aero	punkt aero
.tech	punkt tech
.best	punkt best
.scot	punkt scot
.win	punkt win
.ni	punkt ni
.bzh	punkt bzh
.lb	punkt lb
.city	punkt city
.digital	punkt digital
.red	punkt red
.pg	punkt pg
.world	punkt world
.ag	punkt ag
.ci	punkt ci
.report	punkt report
.ac	punkt ac
.center	punkt center
.ad	punkt ad
.ovh	punkt ovh
.om	punkt om
.cloud	punkt cloud
.press	punkt press
.zw	punkt zw
.vg	punkt vg
.cx	punkt cx
.website	punkt website
.plus	punkt plus
.page	punkt page
.bs	punkt bs
.cd	punkt cd
.gh	punkt gh
.moe	punkt moe
.help	punkt help
.download	punkt download
.ao	punkt ao
.cm	punkt cm
.af	punkt af
.click	punkt click
.mg	punkt mg
.tm	punkt tm
.na	punkt na
.pics	punkt pics
.mv	punkt mv
.market	punkt market
.rw	punkt rw
.fo	punkt fo
.fj	punkt fj
.tl	punkt tl
.gratis	punkt gratis
.art	punkt art
.mc	punkt mc
.mo	punkt mo
.gal	punkt gal
.coop	punkt coop
.nc	punkt nc
.run	punkt run
.mz	punkt mz
.tj	punkt tj
.zone	punkt zone
.cv	punkt cv
.bh	punkt bh
.place	punkt place
.gy	punkt gy
.agency	punkt agency
.kn	punkt kn
.mm	punkt mm
.bid	punkt bid
.bj	punkt bj
.je	punkt je
.gs	punkt gs
.global	punkt global
.lol	punkt lol
.tube	punkt tube
.lc	punkt lc
.bm	punkt bm
.ninja	punkt ninja
.bn	punkt bn
.review	punkt review
.bi	punkt bi
.ht	punkt ht
.sm	punkt sm
.ax	punkt ax
.pm	punkt pm
.ink	punkt ink
.vc	punkt vc
.so	punkt so
.tel	punkt tel
.cw	punkt cw
.uno	punkt uno
.casa	punkt casa
.network	punkt network
.buzz	punkt buzz
.mw	punkt mw
.vu	punkt vu
.guide	punkt guide
.bf	punkt bf
.mq	punkt mq
.sex	punkt sex
.sr	punkt sr
.zm	punkt zm
.onl	punkt onl
.vet	punkt vet
.bw	punkt bw
.jm	punkt jm
.bar	punkt bar
.gp	punkt gp
.pf	punkt pf
.ne	punkt ne
.va	punkt va
.bt	punkt bt
.sd	punkt sd
.expert	punkt expert
.kim	punkt kim
.africa	punkt africa
.mr	punkt mr
.gi	punkt gi
.tg	punkt tg
.cg	punkt cg
.ls	punkt ls
.sb	punkt sb
.ck	punkt ck
.gf	punkt gf
.yt	punkt yt
.dm	punkt dm
.realtor	punkt realtor
.aw	punkt aw
.sz	punkt sz
.london	punkt london
.et	punkt et
.ky	punkt ky
.cool	punkt cool
.lr	punkt lr
.bb	punkt bb
.support	punkt support
.taipei	punkt taipei
.sl	punkt sl
.company	punkt company
.dj	punkt dj
.social	punkt social
.gm	punkt gm
.xn--mgberp4a5d4ar	punkt xn--mgberp4a5d4ar
.love	punkt love
.cymru	punkt cymru
.directory	punkt directory
.games	punkt games
.bio	punkt bio
.wang	punkt wang
.watch	punkt watch
.cafe	punkt cafe
.care	punkt care
.supply	punkt supply
.ooo	punkt ooo
.group	punkt group
.tools	punkt tools
.sx	punkt sx
.rest	punkt rest
.law	punkt law
.wales	punkt wales
.movie	punkt movie
.monster	punkt monster
.studio	punkt studio
.wtf	punkt wtf
.direct	punkt direct
.education	punkt education
.ye	punkt ye
.fit	punkt fit
.events	punkt events
.berlin	punkt berlin
.services	punkt services
.church	punkt church
.pn	punkt pn
.tc	punkt tc
.tf	punkt tf
.nyc	punkt nyc
.town	punkt town
.xn--90ais	punkt xn--90ais
.xn--j1amh	punkt xn--j1amh
.ist	punkt ist
.bet	punkt bet
.sale	punkt sale
.sport	punkt sport
.brussels	punkt brussels
.moscow	punkt moscow
.menu	punkt menu
.express	punkt express
.vlaanderen	punkt vlaanderen
.blue	punkt blue
.cars	punkt cars
.deals	punkt deals
.host	punkt host
.academy	punkt academy
.training	punkt training
.vi	punkt vi
.men	punkt men
.team	punkt team
.canon	punkt canon
.leclerc	punkt leclerc
.solutions	punkt solutions
.community	punkt community
.land	punkt land
.basketball	punkt basketball
.gallery	punkt gallery
.sexy	punkt sexy
.codes	punkt codes
.swiss	punkt swiss
.camp	punkt camp
.software	punkt software
.auction	punkt auction
.nrw	punkt nrw
.style	punkt style
.coffee	punkt coffee
.paris	punkt paris
.graphics	punkt graphics
.holiday	punkt holiday
.wine	punkt wine
.dog	punkt dog
.dating	punkt dating
.radio	punkt radio
.pet	punkt pet
.parts	punkt parts
.international	punkt international
.xin	punkt xin
.bike	punkt bike
.school	punkt school
.stream	punkt stream
.frl	punkt frl
.tours	punkt tours
.audio	punkt audio
.legal	punkt legal
.chat	punkt chat
.xn--wgbl6a	punkt xn--wgbl6a
.photo	punkt photo
.surf	punkt surf
.pink	punkt pink
.xn--p1acf	punkt xn--p1acf
.kiwi	punkt kiwi
.doctor	punkt doctor
.museum	punkt museum
.science	punkt science
.football	punkt football
.xn--80asehdb	punkt xn--80asehdb
.fail	punkt fail
.moda	punkt moda
.party	punkt party
.rip	punkt rip
.fan	punkt fan
.loan	punkt loan
.works	punkt works
.business	punkt business
.bayern	punkt bayern
.money	punkt money
.xn--9dbq2a	punkt xn--9dbq2a
.show	punkt show
.house	punkt house
.futbol	punkt futbol
.krd	punkt krd
.fyi	punkt fyi
.gold	punkt gold
.nagoya	punkt nagoya
.quebec	punkt quebec
.xn--3e0b707e	punkt xn--3e0b707e
.reviews	punkt reviews
.farm	punkt farm
.photography	punkt photography
.photos	punkt photos
.xn--tckwe	punkt xn--tckwe
.cab	punkt cab
.army	punkt army
.hamburg	punkt hamburg
.amsterdam	punkt amsterdam
.pictures	punkt pictures
.cash	punkt cash
.adult	punkt adult
.ski	punkt ski
.poker	punkt poker
.black	punkt black
.fashion	punkt fashion
.clinic	punkt clinic
.gdn	punkt gdn
.tatar	punkt tatar
.exchange	punkt exchange
.date	punkt date
.trade	punkt trade
.boutique	punkt boutique
.shoes	punkt shoes
.ren	punkt ren
.green	punkt green
.band	punkt band
.ltda	punkt ltda
.istanbul	punkt istanbul
.health	punkt health
.webcam	punkt webcam
.earth	punkt earth
.garden	punkt garden
.yoga	punkt yoga
.wien	punkt wien
.ngo	punkt ngo
.xn--80adxhks	punkt xn--80adxhks
.xn--80aswg	punkt xn--80aswg
.xn--fiqs8s	punkt xn--fiqs8s
.repair	punkt repair
.xn--90a3ac	punkt xn--90a3ac
.fitness	punkt fitness
.xn--c1avg	punkt xn--c1avg
.immo	punkt immo
.observer	punkt observer
.vin	punkt vin
.singles	punkt singles
.haus	punkt haus
.okinawa	punkt okinawa
.corsica	punkt corsica
.irish	punkt irish
.university	punkt university
.casino	punkt casino
.how	punkt how
.td	punkt td
.dance	punkt dance
.technology	punkt technology
.barcelona	punkt barcelona
.nf	punkt nf
.golf	punkt golf
.wf	punkt wf
.estate	punkt estate
.yokohama	punkt yokohama
.systems	punkt systems
.rugby	punkt rugby
.wedding	punkt wedding
.healthcare	punkt healthcare
.koeln	punkt koeln
.enterprises	punkt enterprises
.film	punkt film
.xn--node	punkt xn--node
.accountant	punkt accountant
.taxi	punkt taxi
.tienda	punkt tienda
.nr	punkt nr
.toys	punkt toys
.gent	punkt gent
.vision	punkt vision
.rent	punkt rent
.fans	punkt fans
.energy	punkt energy
.jetzt	punkt jetzt
.cards	punkt cards
.domains	punkt domains
.marketing	punkt marketing
.soy	punkt soy
.foundation	punkt foundation
.horse	punkt horse
.fish	punkt fish
.promo	punkt promo
.institute	punkt institute
.restaurant	punkt restaurant
.exposed	punkt exposed
.flowers	punkt flowers
.gift	punkt gift
.jewelry	punkt jewelry
.ki	punkt ki
.coach	punkt coach
.clothing	punkt clothing
.fund	punkt fund
.finance	punkt finance
.dental	punkt dental
.forsale	punkt forsale
.tirol	punkt tirol
.xn--mgbayh7gpa	punkt xn--mgbayh7gpa
.family	punkt family
.xn--80ao21a	punkt xn--80ao21a
.gn	punkt gn
.xn--d1acj3b	punkt xn--d1acj3b
.madrid	punkt madrid
.soccer	punkt soccer
.eco	punkt eco
.kitchen	punkt kitchen
.consulting	punkt consulting
.immobilien	punkt immobilien
.xn--90ae	punkt xn--90ae
.beer	punkt beer
.capital	punkt capital
.rio	punkt rio
.miami	punkt miami
.alsace	punkt alsace
.archi	punkt archi
.ruhr	punkt ruhr
.lgbt	punkt lgbt
.hosting	punkt hosting
.delivery	punkt delivery
.limited	punkt limited
.properties	punkt properties
.baby	punkt baby
.bible	punkt bible
.schule	punkt schule
.bnpparibas	punkt bnpparibas
.shopping	punkt shopping
.partners	punkt partners
.recipes	punkt recipes
.bank	punkt bank
.lighting	punkt lighting
.ong	punkt ong
.hm	punkt hm
.srl	punkt srl
.discount	punkt discount
.gifts	punkt gifts
.pizza	punkt pizza
.vegas	punkt vegas
.bot	punkt bot
.builders	punkt builders
.llc	punkt llc
.tax	punkt tax
.realty	punkt realty
.equipment	punkt equipment
.gmbh	punkt gmbh
.tattoo	punkt tattoo
.homes	punkt homes
.saarland	punkt saarland
.property	punkt property
.kyoto	punkt kyoto
.xn--y9a3aq	punkt xn--y9a3aq
.solar	punkt solar
.weber	punkt weber
.gop	punkt gop
.mom	punkt mom
.fishing	punkt fishing
.cricket	punkt cricket
.faith	punkt faith
.inc	punkt inc
.rentals	punkt rentals
.build	punkt build
.college	punkt college
.sharp	punkt sharp
.camera	punkt camera
.xn--h2brj9c	punkt xn--h2brj9c
.cern	punkt cern
.sydney	punkt sydney
.dhl	punkt dhl
.salon	punkt salon
.cologne	punkt cologne
.cyou	punkt cyou
.game	punkt game
.vote	punkt vote
.flights	punkt flights
.glass	punkt glass
.melbourne	punkt melbourne
.hiphop	punkt hiphop
.mba	punkt mba
.post	punkt post
.voyage	punkt voyage
.ventures	punkt ventures
.courses	punkt courses
.kaufen	punkt kaufen
.productions	punkt productions
.abudhabi	punkt abudhabi
.hospital	punkt hospital
.shiksha	punkt shiksha
.racing	punkt racing
.furniture	punkt furniture
.capetown	punkt capetown
.aq	punkt aq
.engineering	punkt engineering
.study	punkt study
.luxury	punkt luxury
.reisen	punkt reisen
.sandvik	punkt sandvik
.surgery	punkt surgery
.hockey	punkt hockey
.audi	punkt audi
.contractors	punkt contractors
.florist	punkt florist
.cheap	punkt cheap
.actor	punkt actor
.computer	punkt computer
.xn--mgbaam7a8h	punkt xn--mgbaam7a8h
.coupons	punkt coupons
.management	punkt management
.organic	punkt organic
.cooking	punkt cooking
.markets	punkt markets
.construction	punkt construction
.voto	punkt voto
.realestate	punkt realestate
.xn--l1acc	punkt xn--l1acc
.engineer	punkt engineer
.lawyer	punkt lawyer
.physio	punkt physio
.yandex	punkt yandex
.pharmacy	punkt pharmacy
.insure	punkt insure
.boston	punkt boston
.xn--j6w193g	punkt xn--j6w193g
.guitars	punkt guitars
.saxo	punkt saxo
.car	punkt car
.osaka	punkt osaka
.xn--mk1bu44c	punkt xn--mk1bu44c
.industries	punkt industries
.tennis	punkt tennis
.abbott	punkt abbott
.sap	punkt sap
.xn--ses554g	punkt xn--ses554g
.gw	punkt gw
.credit	punkt credit
.xn--kpry57d	punkt xn--kpry57d
.supplies	punkt supplies
.holdings	punkt holdings
.ryukyu	punkt ryukyu
.diamonds	punkt diamonds
.apartments	punkt apartments
.associates	punkt associates
.cruises	punkt cruises
.fk	punkt fk
.theater	punkt theater
.ceo	punkt ceo
.rodeo	punkt rodeo
.attorney	punkt attorney
.viajes	punkt viajes
.google	punkt google
.auto	punkt auto
.kp	punkt kp
.diet	punkt diet
.joburg	punkt joburg
.gives	punkt gives
.villas	punkt villas
.financial	punkt financial
.sarl	punkt sarl
.catering	punkt catering
.vacations	punkt vacations
.rehab	punkt rehab
.xn--fiqz9s	punkt xn--fiqz9s
.gu	punkt gu
.investments	punkt investments
.qpon	punkt qpon
.forex	punkt forex
.gripe	punkt gripe
.stockholm	punkt stockholm
.career	punkt career
.bingo	punkt bingo
.limo	punkt limo
.xn--d1alf	punkt xn--d1alf
.storage	punkt storage
.cleaning	punkt cleaning
.dentist	punkt dentist
.hiv	punkt hiv
.degree	punkt degree
.plumbing	punkt plumbing
.citic	punkt citic
.crs	punkt crs
.edeka	punkt edeka
.lease	punkt lease
.bargains	punkt bargains
.durban	punkt durban
.condos	punkt condos
.loans	punkt loans
.xn--wgbh1c	punkt xn--wgbh1c
.uol	punkt uol
.accountants	punkt accountants
.country	punkt country
.seat	punkt seat
.aws	punkt aws
.yachts	punkt yachts
.luxe	punkt luxe
.barclays	punkt barclays
.bradesco	punkt bradesco
.xn--55qx5d	punkt xn--55qx5d
.maison	punkt maison
.kred	punkt kred
.xn--czr694b	punkt xn--czr694b
.xn--e1a4c	punkt xn--e1a4c
.xn--ngbc5azd	punkt xn--ngbc5azd
.komatsu	punkt komatsu
.reise	punkt reise
.xn--kput3i	punkt xn--kput3i
.trading	punkt trading
.claims	punkt claims
.xn--q9jyb4c	punkt xn--q9jyb4c
.mortgage	punkt mortgage
.arpa	punkt arpa
.xn--o3cw4h	punkt xn--o3cw4h
.ricoh	punkt ricoh
.xn--6qq986b3xl	punkt xn--6qq986b3xl
.sener	punkt sener
.xn--54b7fta0cc	punkt xn--54b7fta0cc
.versicherung	punkt versicherung
.mango	punkt mango
.charity	punkt charity
.feedback	punkt feedback
.security	punkt security
.ipiranga	punkt ipiranga
.xn--qxam	punkt xn--qxam
.xn--zfr164b	punkt xn--zfr164b
.creditunion	punkt creditunion
.afl	punkt afl
.christmas	punkt christmas
.broker	punkt broker
.vodka	punkt vodka
.xn--czru2d	punkt xn--czru2d
.gay	punkt gay
.tickets	punkt tickets
.memorial	punkt memorial
.xn--t60b56a	punkt xn--t60b56a
.neustar	punkt neustar
.mma	punkt mma
.xn--io0a7i	punkt xn--io0a7i
.xn--3ds443g	punkt xn--3ds443g
.navy	punkt navy
.aquarelle	punkt aquarelle
.juegos	punkt juegos
.km	punkt km
.total	punkt total
.democrat	punkt democrat
.sucks	punkt sucks
.tires	punkt tires
.fage	punkt fage
.xn--mgbab2bd	punkt xn--mgbab2bd
.jll	punkt jll
.blackfriday	punkt blackfriday
.jcb	punkt jcb
.xn--vuq861b	punkt xn--vuq861b
.weir	punkt weir
.aco	punkt aco
.boats	punkt boats
.republican	punkt republican
.man	punkt man
.motorcycles	punkt motorcycles
.hsbc	punkt hsbc
.abogado	punkt abogado
.reit	punkt reit
.axa	punkt axa
.xn--6frz82g	punkt xn--6frz82g
.sky	punkt sky
.dvag	punkt dvag
.insurance	punkt insurance
.kpn	punkt kpn
.praxi	punkt praxi
.globo	punkt globo
.statebank	punkt statebank
.xn--fiq228c5hs	punkt xn--fiq228c5hs
.bmw	punkt bmw
.xn--g2xx48c	punkt xn--g2xx48c
.abb	punkt abb
.toray	punkt toray
.hisamitsu	punkt hisamitsu
.philips	punkt philips
.schwarz	punkt schwarz
.monash	punkt monash
.airforce	punkt airforce
.erni	punkt erni
.latrobe	punkt latrobe
.xn--czrs0t	punkt xn--czrs0t