/giờ	trên giờ
/h	trên giờ
/ngày	trên ngày
/d	trên ngày
/tuần	trên tuần
/tháng	trên tháng
/năm	trên năm
/phút	trên phút
/p	trên phút
/giây	trên giây
/s	trên giây
/lần	một lần
/cái	một cái
/chiếc	một chiếc
/người	một người
/chỗ	một chỗ
/bài	một bài
/trang	một trang
/từ	một từ
/đồng	một đồng
/đêm	một đêm
/buổi	một buổi
/ca	một ca
/dự án	một dự án
/lớp	một lớp
/khóa	một khóa
/suất	một suất
/tấn	một tấn