킬로미터	km
미터	m
센티미터	cm
밀리미터	mm
마이크로미터	μm
나노미터	nm
킬로그램	kg
그램	g
톤	t
밀리그램	mg
마이크로그램	μg
리터	L
밀리리터	ml
씨씨	cc
시간	h
분	min
초	s
뉴턴	N
와트	W
킬로와트	kW
킬로와트시	kWh
헤르츠	Hz
킬로헤르츠	kHz
메가헤르츠	MHz
기가헤르츠	GHz
도	°
퍼센트	%
프로	%
분당회전수	rpm
알피엠	rpm
볼트	V
밀리볼트	mV
킬로볼트	kV
암페어	A
밀리암페어	mA
평	py
제곱미터	m²
제곱킬로미터	km²
제곱센티미터	cm²
세제곱미터	m³
기가바이트	GB
기가	GB
테라바이트	TB
테라	TB
메가바이트	MB
메가	MB
킬로바이트	KB
바이트	B
비트	bit
칼로리	cal
킬로칼로리	kcal
줄	J
킬로줄	kJ
마력	hp
옴	Ω
파스칼	Pa
헥토파스칼	hPa
데시벨	dB
루멘	lm
럭스	lx
픽셀	px