eurocent	euro
eurocents	euro
euro cent	euro
euro cents	euro
us cent	dollar
us cents	dollar
u s cent	dollar
u s cent	dollar
penny	pfund
pence	pfund
sen	yen
centime	franken
centimes	franken
rappen	franken
paisa	rupien
paise	rupien
kopeke	rubel
kopeken	rubel
grosz	złoty
groszen	złoty
öre	schwedische kronen
öre	schwedische krone
øre	norwegische kronen
øre	norwegische krone
øre	dänische kronen
øre	dänische krone
heller	kronen
lipa	kuna



